from	to
Northern Europe	Europe
Eastern Asia	Asia
World	World
Northern America	Americas
Western Asia	Asia
Central Asia	Asia
Melanesia	Oceania
Northern Africa	Africa
Micronesia	Oceania
Eastern Europe	Europe
Southern Asia	Asia
Sub-Saharan Africa	Africa
Latin America and the Caribbean	Americas
Australia and New Zealand	Oceania
nan	nan
South-eastern Asia	Asia
Western Europe	Europe
Polynesia	Oceania
Southern Europe	Europe
