from	to
TKM	Central Asia
PHL	South-eastern Asia
SYC	Sub-Saharan Africa
IND	Southern Asia
VAT	Southern Europe
BMU	Northern America
ITA	Southern Europe
ALA	Northern Europe
TCD	Sub-Saharan Africa
FRO	Northern Europe
DEU	Western Europe
MDV	Southern Asia
BOL	Latin America and the Caribbean
MSR	Latin America and the Caribbean
BHR	Western Asia
KOR	Eastern Asia
BWA	Sub-Saharan Africa
SYR	Western Asia
TKL	Polynesia
GLP	Latin America and the Caribbean
USA	Northern America
COK	Polynesia
SWZ	Sub-Saharan Africa
MLT	Southern Europe
BTN	Southern Asia
JAM	Latin America and the Caribbean
SXM	Latin America and the Caribbean
MNG	Eastern Asia
AND	Southern Europe
MMR	South-eastern Asia
EGY	Northern Africa
ABW	Latin America and the Caribbean
IOT	Sub-Saharan Africa
LBY	Northern Africa
SJM	Northern Europe
DMA	Latin America and the Caribbean
SLB	Melanesia
MNP	Micronesia
PRK	Eastern Asia
MHL	Micronesia
MOZ	Sub-Saharan Africa
TCA	Latin America and the Caribbean
PCN	Polynesia
IMN	Northern Europe
DNK	Northern Europe
CYM	Latin America and the Caribbean
GUM	Micronesia
RWA	Sub-Saharan Africa
SLE	Sub-Saharan Africa
LTU	Northern Europe
VIR	Latin America and the Caribbean
ZMB	Sub-Saharan Africa
CUB	Latin America and the Caribbean
GMB	Sub-Saharan Africa
MDG	Sub-Saharan Africa
NIC	Latin America and the Caribbean
VUT	Melanesia
CYP	Western Asia
CRI	Latin America and the Caribbean
SUR	Latin America and the Caribbean
ECU	Latin America and the Caribbean
BGD	Southern Asia
BIH	Southern Europe
MEX	Latin America and the Caribbean
ATA	nan
JEY	Northern Europe
FSM	Micronesia
UMI	Micronesia
CZE	Eastern Europe
ZWE	Sub-Saharan Africa
SHN	Sub-Saharan Africa
ESP	Southern Europe
COD	Sub-Saharan Africa
VNM	South-eastern Asia
CPV	Sub-Saharan Africa
ATG	Latin America and the Caribbean
GUF	Latin America and the Caribbean
SGS	Latin America and the Caribbean
HMD	Australia and New Zealand
TUV	Polynesia
KNA	Latin America and the Caribbean
PLW	Micronesia
AIA	Latin America and the Caribbean
BGR	Eastern Europe
YEM	Western Asia
PAN	Latin America and the Caribbean
LSO	Sub-Saharan Africa
SVN	Southern Europe
MKD	Southern Europe
SVK	Eastern Europe
BRB	Latin America and the Caribbean
CHN	Eastern Asia
ISL	Northern Europe
GRD	Latin America and the Caribbean
NRU	Micronesia
MTQ	Latin America and the Caribbean
MWI	Sub-Saharan Africa
CMR	Sub-Saharan Africa
TJK	Central Asia
ISR	Western Asia
GBR	Northern Europe
LAO	South-eastern Asia
COG	Sub-Saharan Africa
REU	Sub-Saharan Africa
RUS	Eastern Europe
WLF	Polynesia
SMR	Southern Europe
BEL	Western Europe
BES	Latin America and the Caribbean
AZE	Western Asia
BFA	Sub-Saharan Africa
HKG	Eastern Asia
AFG	Southern Asia
BLR	Eastern Europe
MCO	Western Europe
UKR	Eastern Europe
LBN	Western Asia
TTO	Latin America and the Caribbean
PNG	Melanesia
TUR	Western Asia
NLD	Western Europe
AGO	Sub-Saharan Africa
OMN	Western Asia
CCK	Australia and New Zealand
COL	Latin America and the Caribbean
PRY	Latin America and the Caribbean
CUW	Latin America and the Caribbean
MLI	Sub-Saharan Africa
POL	Eastern Europe
TGO	Sub-Saharan Africa
MUS	Sub-Saharan Africa
KWT	Western Asia
MNE	Southern Europe
KEN	Sub-Saharan Africa
IRN	Southern Asia
NFK	Australia and New Zealand
COM	Sub-Saharan Africa
KIR	Micronesia
TLS	South-eastern Asia
AUS	Australia and New Zealand
SWE	Northern Europe
PSE	Western Asia
SDN	Northern Africa
CXR	Australia and New Zealand
KGZ	Central Asia
VCT	Latin America and the Caribbean
BVT	Latin America and the Caribbean
SEN	Sub-Saharan Africa
TZA	Sub-Saharan Africa
FRA	Western Europe
GHA	Sub-Saharan Africa
CIV	Sub-Saharan Africa
URY	Latin America and the Caribbean
ETH	Sub-Saharan Africa
FLK	Latin America and the Caribbean
NZL	Australia and New Zealand
PRT	Southern Europe
BRN	South-eastern Asia
GTM	Latin America and the Caribbean
HUN	Eastern Europe
SRB	Southern Europe
LIE	Western Europe
NER	Sub-Saharan Africa
BLM	Latin America and the Caribbean
MAR	Northern Africa
SSD	Sub-Saharan Africa
LKA	Southern Asia
NAM	Sub-Saharan Africa
FJI	Melanesia
LUX	Western Europe
ARE	Western Asia
CAN	Northern America
AUT	Western Europe
SOM	Sub-Saharan Africa
ZAF	Sub-Saharan Africa
NPL	Southern Asia
MDA	Eastern Europe
KAZ	Central Asia
NIU	Polynesia
PAK	Southern Asia
PER	Latin America and the Caribbean
STP	Sub-Saharan Africa
MYT	Sub-Saharan Africa
MAF	Latin America and the Caribbean
CHE	Western Europe
SGP	South-eastern Asia
DZA	Northern Africa
KHM	South-eastern Asia
IRL	Northern Europe
SLV	Latin America and the Caribbean
VEN	Latin America and the Caribbean
GRL	Northern America
JOR	Western Asia
BDI	Sub-Saharan Africa
BEN	Sub-Saharan Africa
CAF	Sub-Saharan Africa
ATF	Sub-Saharan Africa
HTI	Latin America and the Caribbean
CHL	Latin America and the Caribbean
ERI	Sub-Saharan Africa
IRQ	Western Asia
SAU	Western Asia
VGB	Latin America and the Caribbean
BRA	Latin America and the Caribbean
HND	Latin America and the Caribbean
LBR	Sub-Saharan Africa
TON	Polynesia
TUN	Northern Africa
GNQ	Sub-Saharan Africa
DOM	Latin America and the Caribbean
WSM	Polynesia
ROU	Eastern Europe
EST	Northern Europe
MYS	South-eastern Asia
QAT	Western Asia
ALB	Southern Europe
WLD	World
GIB	Southern Europe
GGY	Northern Europe
MAC	Eastern Asia
IDN	South-eastern Asia
MRT	Sub-Saharan Africa
NGA	Sub-Saharan Africa
NCL	Melanesia
GNB	Sub-Saharan Africa
SPM	Northern America
TWN	Eastern Asia
GEO	Western Asia
UGA	Sub-Saharan Africa
ESH	Northern Africa
NOR	Northern Europe
GRC	Southern Europe
THA	South-eastern Asia
PYF	Polynesia
ARG	Latin America and the Caribbean
GAB	Sub-Saharan Africa
ASM	Polynesia
FIN	Northern Europe
GUY	Latin America and the Caribbean
ARM	Western Asia
PRI	Latin America and the Caribbean
UZB	Central Asia
GIN	Sub-Saharan Africa
DJI	Sub-Saharan Africa
LVA	Northern Europe
BLZ	Latin America and the Caribbean
BHS	Latin America and the Caribbean
LCA	Latin America and the Caribbean
HRV	Southern Europe
JPN	Eastern Asia
